1111111111111
1000C100000C1
1000011111001
1P00000E000C1
1000011111001
1000010001001
100C011001001
1000010011C01
1111111111111